..........
.C........
..C.......
...O......
....O.....
.....#....
......X...
.......~..
..........
..........
