..........
.X........
..C.......
...O......
..........
..........
..........
..........
........X.
.........C
